111111111111111111111111
1E001000P000000C00000C01
101000000010000010000101
100C00100100100000000001
100010001000C0000C000001
100100C00C00001000010001
1C00000E0000C0000C000001
111111111111111111111111