1111111111111111111111
1P00C000C0000C0000C001
1001111111111111111001
10100000000000000001C1
1010000000000000000101
10011111111111111110C1
10000000000000000000E1
1111111111111111111111