11111111111111111111111111111111111111111111111111111111111111111111
11111111111111111111111111111111111111111111111111111111111111111111
111111P11111111111111111111111111111111111111111111111111111C1111111
11111111111111111111111111111111111111111111111111111111111111111111
11111111111111111111111111111111111111111111111111111111111111111E11
11111111111111111111111111111111111111111111111111111111111111111111