1111111111111111111111111111111111
1000000000000000000000000000000001
1011000000100000101001000000010101
1010000010101010001001000000010101
1P100000000000000000000000E0000001
1111111111111111111111111111111111