1111111
1PC0001
100C001
1000CE1
1111111
