1111111111
1ELCLCZSS1
1WLLLLLLL1
10000000C1
1WLLLLLLL1
10C00000S1
10LLLLLLL1
1P0000BLN1
1111111111
