1111111111111
1SSSSSSSSSSS1
1SLSSLCLLLSS1
1SLSSLCSSSLS1
1SSLLLCLLLLS1
1SSSSLCLSSSS1
1SSSSLCSLLLS1
1SSSSSESSSSS1
1SSSSSPSSSSS1
1111111111111
