1111111111
1C11111L11
1LLBCLC011
1111111B11
1SS0000011
1EL0111111
110000BP11
1111111111
1111111111
