111111111111111111111111111111111111111
1010000000C00010001C00100C0000100S001K1
1010111011111110111C1110101C1110101C101
10001010000L001010000000101010001010SP1
101110111111101011111011101110111011111
101000CC000C10100L0010001000C010L010C01
1011111110111011111011111111111C1110101
1C0C1000100010C0S01000100C0L0010C000101
111010101110111110111010111110111111101
100000100000000E1000CC001SC0000000C0001
111111111111111111111111111111111111111
