111111111
1LSLPSLL1
1LLL1LLS1
1LS11SLS1
1LL11LLL1
1LSL1SLS1
1LC111SL1
1LLLELLL1
111111111
