111111111
100000001
101111101
101PCE101
101111101
100000001
111111111
