111111111
1BLLSLLB1
1W0111ZW1
1SSPCWES1
1WSSSS0W1
1NSSKSSB1
111111111
