111111111
1LLLLLLL1
1L11111L1
1L1PCE1L1
1L11111L1
1LLLLLLL1
111111111
