1111111111
10000000E1
1010010001
1010010001
101LC100C1
1011111111
1000C1S001
1P00010001
1000010001
1111111111
