111111111111111111111111111111
1E0B00000000000000000000000001
10NB00000000000000000000000001
1BBB00000000000000000000000001
100000000000000000000000000001
100000000000000000000000000001
100000000000000000000000000001
1C0000000000000000000000000001
1S000000000000000000000000Z001
1P0000000000000000000000000001
111111111111111111111111111111
