11111111111
1W0000000E1
1010001BBL1
1010W010BB1
1L100N10P01
10111111111
10W0WC1S0W1
1B000010W01
100W00L00Z1
11111111111
