111111111111111111111
1P10000000001C00000C1
101011111110111110101
10001C001000100000101
101110101010101110101
100L10100010100010101
101110101110101011101
100C101010101L1C10001
101111101010111111101
10000010S010000L10001
111011101111111110111
1S001000001010000S101
101011101110101111101
1010001L0010C01010001
101011111010111011101
101010000000100010001
1011111L1110101010111
100C1C001S10101000001
101011101010101111111
10100L100010000000CE1
111111111111111111111