11111111111111
1E00l000000001
11101111S11111
10B00C00000001
1S111111111111
10000L00P00001
11111111111111
