111111111111111111111111111111
1P0000000000000000000000000001
1C0000000000000000000000000001
100000000000000000000000000001
100000000000000000000000000001
10000000000S00L000000000000001
100000000000000000000000000001
100000000L00000000000000000001
10000000000000000000000000E001
100000000000000000000000000001
111111111111111111111111111111
