1111111111111111111111111111111111
1P0000000000000C00000C0000000000P1
100000C000000000100000000000000001
1000C00000000000001000000000000001
1P0000000000C000000000E00000000001
1111111111111111111111111111111111