1111111111111111
1L000000000000L1
1011111111111101
1000000L00000001
100P000S0000E0C1
1000000L00000001
1011111111111101
1L000000000000L1
1111111111111111