1111111111111111
1111111111111111
110C000000000S11
1100000000000011
11000000C0000011
11S000000000P011
1111000111111111
1111LLL111111111
10000001000000S1
1000000100000001
1000000100000001
1LLL010000000001
1LLL000100000001
1ELL000100000S01
1111111111111111