11111111111111111
1P00000001C000111
11000000001100001
10000000000111101
10110000000011101
10111111111111101
101111000000000L1
10000000111111111
10111111C00000001
100000000000000E1
11111111111111111