1111111111111111111
1000000000000000001
1011111111111111101
1011EEEEEEEEEEE1101
1011EEEEEEEEEEE1101
1011EEEEEEEEEEE1101
1011EEEEEEEEEEE1101
1011111111111111101
1011111111111111101
1011111111111111101
1011111111111111101
1011111111111111101
101111110P011111101
101111110C011111101
101111110C011111101
100000000C000000001
1111111111111111111