1111111111111111111111111111111111111111111111111111111
1000000000000000000CCCCCCCCCCCCCCCCCC000000000000000001
1000000000000000CCCCCCCCCCPCCCCCCCCCCCC0000000000000001
100000000000CCCCCCCCCCCCCCCCCCCCCCCCCCCCCCC000000000001
100000000CCCCCCCCCCCCCCCCCCCCCCCCCCCCCCCCCCCCC000000001
1000000CCCCCCCCCCCCCCCCCCCCCCCCCCCCCCCCCCCCCCCCC0000001
10000CCCCCCCCCCCCCCCCCCCCCCCCCCCCCCCCCCCCCCCCCCCCC00001
1000CCCCCCCCCCCCE00ECCCCCCCCCCCCCCE00ECCCCCCCCCCCCC0001
100CCCCCCCCCCCC001000CCCCCCCCCCCC001000CCCCCCCCCCCCC001
100CCCCCCCCCCCCCC00CCCCCCCCCCCCCCCC00CCCCCCCCCCCCCCC001
10CCCCCCCCCCCCCCCCCCCCCCCCCCCCCCCCCCCCCCCCCCCCCCCCCCC01
10CCCCC00000CCCCCCCCCCCCCCCCCCCCCCCCCCCCCCC00000CCCCC01
10CCCCCCC0CCCCCCCCCCCCCCCCCCCCCCCCCCCCCCCCCCC0CCCCCCC01
100ECCCCC00CCCCCCCCCCCCCCCCCCCCCCCCCCCCCCCCC00CCCCCE001
100ECCCCCC00ECCCCCCCCCCCCCCCCCCCCCCCCCCCCCE00CCCCCCE001
1000ECCCCCC00ECCCCCCCCCCCCCCCCCCCCCCCCCCCE00CCCCCCE0001
10000ECCCCCCC00ECCCCCCCCCCCCCCCCCCCCCCCE00CCCCCCCE00001
1000000ECCCCCCCC00ECCCCCCCCCCCCCCCCCE00CCCCCCCCE0000001
100000000ECCCCCCCCC00ECCCCCCCCCCCE00CCCCCCCCCE000000001
100000000000ECCCCCCCCC00000000000CCCCCCCCCE000000000001
1000000000000000ECCCCCCCCCCCCCCCCCCCCCE0000000000000001
100000000000000000000EECCCCCCCCCEE000000000000000000001
1111111111111111111111111111111111111111111111111111111