1111111111111111111111111111111111
1111111111111111111111111111111111
11111111CCC11111111111CCCCCCCCC111
1111111C11C11111111111C111111C1111
11111CC111C1111111111111111CC11111
1111C11111C11110P011111111C1111111
111C111111C11110E01111111C11111111
11CCCCCCCCC111100011111CC111111111
1111111111C11111111111C11111111111
1111111111C1111111111CCCCCCCCCCC11
1111111111111111111111111111111111
1111111111111111111111111111111111