1111111111111111111111111111
10000C00C0L00P10000C00000001
10L00C00E00C010000000C000001
1000E010010010100L000L00L001
101000L00E000L00L00010011001
101LL00000C00C0000C000000001
10000L0001010C00100000C00001
100C0010L00L001000L001000001
10100L0000C00C00C0000C000001
100C000C00E000C000C01010C001
1111111111111111111111111111