11111111111111111111
10000000000000000001
10000000000000000001
1000000000000L000001
10000P00000000000001
10000000E00000000001
10000C00000000000001
100000000S0000000001
100000000000000S0001
11111111111111111111