11111111111111111111
1PSSSSSSSLLLLLLLLSS1
1CCCCCCLLLLLLLLLCCC1
1SSSSSSSSS0000SSSSS1
1CCCCC0000L0000CCCC1
1LLLLLLSSSSSSSSSSSS1
1CLCCCCCCCC0000CCCC1
1CLL00000CCCCCCCCCC1
1SLSSSSSSSSSSSSSSSS1
1CCCCCCCCCCCCCCCCCC1
1SSSSSSLSSSSSSSSSSS1
1LLC11LLLCCCCCCCCCE1
11111111111111111111