11111111111111111111111111111111111111111111111111
11111100000000E11111111111111111111111111111111111
111111C000111111111111111111111100000P011111111111
11110000C00000000C000000000C0000000000000011111111
11111111111111111111111111111111111111111111111111