111111
1LC1C1
1P0E01
1C0CC1
1C0LC1
111111