1111111
1L0C0L1
10C1C01
10CPC01
1C1C1C1
1LLELL1
1111111