11111111111111111111
1000S00000000L000001
10E001100S0C00S00001
1L000110C00000S00001
100P0C0C00L000000001
100S000S00000000L001
11111111111111111111