11111111111111111111
10100L00100C00C00001
10C00C0L0C00C00C0101
100C010C00L00L100001
10100P0L00L000L00101
10C0C000E0C00C001C01
10100C0L00C0C000L001
10C10C010S0C00C00001
100C00L00L0L000S0001
11111111111111111111