1111111111111111111111111111111111111111111111111
1111111111111111111111111111111111111111111111111
111111P1111111111111111111111111111111111C1111111
1111111111111111111111111111111111111111111111111
1111111111111111111111111111111111111111111111E11
1111111111111111111111111111111111111111111111111