1111111111111111111111111111111111
1000000E0000000C00000C0000C0000001
1000C000000C0000101001000C000C0001
10C0000C000000C0001001000000000001
100000000C00C000000000000C000000C1
1111111111111111111111111111111111