1111111111111111111111111
1P1111L101C00000000001111
1S1LLLL10L11LLLL110LLL1E1
100L00000L100C0L11011L1L1
111L0LLLLLL0L1C0C0011L001
1000C00000L0111L11S11L011
1S1LLLLLLLL0L11L11CLLL001
1L1111L11S00L11S111111101
1S1LLLL11LLLL11S11LLLLL01
1S1111111111111S11L11L1C1
1LS001LC1LLLLLLS01L11L111
1S1111LC1111111L0111C1111
1S1LLLLLLSLLLCLL01LLLLLL1
1C1L11111S11L11101111LS11
1LLL11LLLLLLLLLL01L11LS11
1SCS1CC1100CCSSS00L000SC1
1111111111111111111111111