1111111111111111111
1P00000000001000001
1111001111001001001
1001000001001001001
1001111001001111001
1000000001000000001
1001111001111111111
1111000001001000001
1001111111S01001111
1000001001LSL00SSS1
1111001001SL1111111
1000000001LLSLCSLE1
1111111111111111111