111111111111111111111111111
1C1S1C1S1C1S1C1S1C1S1C1E1S1
111L11L11L11L11L11L11L11L11
1S1S1S1S1S1S1S1S1S1S1S1S1S1
111L11L11L11L11L11L11L11L11
1C1C1C1C1C1C1C1C1C1C1C1C1C1
1S1S1S1S1S1S1S1S1S1S1S1S1S1
111L11L11L11L11L11L11L11L11
1C1C1C1C1C1C1C1C1C1C1C1C1C1
111L11L11L11L11L11L11L11L11
1S1S1S1S1S1S1S1S1S1S1S1S1S1
1C1C1C1C1C1C1C1C1C1C1C1C1C1
111L11L11L11L11L11L11L11L11
1P1S1S1S1S1S1S1S1S1S1S1S1S1
111111111111111111111111111