1111111111
1E00000001
11111111C1
1000000001
1S11111111
10000000P1
1111111111