11111111
1CL00LE1
1SC10001
1PS0L001
11111111