111111111111111111
1PS1000100L01000L1
1E0100001111000101
1001010000100001S1
10100111100000E101
10L001LC0010011101
111111111110L00001
11E0100C10000111C1
1L0000001000000L11
1C10010000L1L010E1
111111111111111111