11111111
1CL0LCC1
1CLCLCC1
1110LEL1
1L000LL1
110CL001
1000L011
10110001
10100001
10L0LL01
10S0S1S1
1P0C0C01
1S001SS1
1LL0LLL1
1C00CCC1
1L0LL0L1
100100C1
1SCS00E1
11111111