1111111111111111
1PS00000000010C1
1111111SC10010L1
1L00000001000C01
1001111111111111
11010000010000C1
1001001001001001
100S00100L001LE1
1111111111111111