1111111111111111111111111111111111
1P00000000000000000000000000000001
1C00000000000000000000000000000001
1000000000000000000000000000000001
1C00000000000000000000000000000001
1000000000000000000000000000000001
1C00000000000000000000000000000001
1000000000000000000000000000000001
1C00000000000000000000000000000001
1000000000000000000000000000000001
1C00000000000000000000000000000001
10000000000000000000000000000000E1
1111111111111111111111111111111111