11111111111111111111111111111111111111111111111111111111111111
10000000000000000000000000000000000000000000000000000000000001
1000000000000000000000001111111111111111000000000000000C000001
10000000000000000000111111111111111111111111000000000000000001
10000000000000000111111111111111111111111111111000000000000001
10000000000000011111111111111111000000000001111110000000000001
10000000000001111111111111111000000000000000000111100000000001
10000000000011111111111110110000000000000000000000110000000001
10000000000111111110000001100000000000000000000000001000000001
10000000000111111101101111000000000000000000000000000000000001
10000C00001111111110000011100000000000000000000000000000000001
100000000011111111111011111110000000000000000000000000000000C1
10000000001111111000011111111110000000000E0000000000P000000001
10000000001111110101111110111111000000000000000000000000000001
10000000000111111100111111100000000000000000000000000000000001
10000000000111111110000000000000000000000000000000001000000001
10000000000011111111110000000000000000000000000000110000000001
10000000000001111111111111111000000000000000000111100000000001
100000000000000111111111111111110000000000011111100000000C0001
1C000000000000000111111111111111111111111111111000000000000001
10000000000000000000111111111111111111111111000000000000000001
10000000000000000C00000011111111111111110000000000000000000001
10000000000000000000000000000000000000000000000000000000000001
11111111111111111111111111111111111111111111111111111111111111