111111111
1P01C0C01
110C01001
1P00CCE01
111111111