11111111111111111111
1CCCC1CCCCCCCC1CCCC1
1C11C1C11CC11C1C11C1
1CCCCCC0L00L1CCCCCC1
1C1C11C110111C11C1C1
1C1CCCC10CCC1C1CC1C1
1C1C11C101101C1C11C1
1E1CCCCCCPCCCC1CCCC1
11111111111111111111