1111111111
1ES0000001
1111111101
1CL0000001
1111111101
1P00000001
1111111111