111111111111111111111111111111111111111111111111111
1P10C000100L00100C0C00C0C0100C00C0L0101000100S00001
1SL111000111011111110111111111110111110101011101111
1SLC0010C0C00C00101010000C000000101000101010C000101
101111111110101010101011101011111010111110111010101
1SS0100C00101010L00010101010001010100CC000100010001
101111101111111111101110101111101011111110101110111
10001000001010000L0C00101000100S001C00000010S010001
111111111010111110101010101111101110101011111111101
100S100C00C00C0C00101000100S000C0010101010100000101
1011111011101111111110111110111111101111101011111C1
10100C101000001000C000C0L0100010100L0C0C00C0C010001
101010101111101111101111101011101111101110101111101
1000101010L0101000L000100C00001010L0101010100S0S001
1011101110111011111011101110111011101C1011101111101
1010100C000000101000100S0010C0C0C0C000001S001E10001
101011111111111010111011111111111011101111101010111
1000000010C010101010100C0C0CL010100010100S001010001
101110111010101010101010101111101010111011111011101
1010L0S000100010001000101C0000100010C0100L001000001
111111111111111111111111111111111111111111111111111