111111111111111111111111111
10000000000000E000000000001
1000000000LLLLLLLL000000001
10000000LLLLLLLLLLLL0000001
1000000LLLLLLLLLLLLLL000001
100000LLLLLLLLLLLLLLLL00001
100000LLLLLLLLLLLLLLLL00001
10000LLLLLLLLLLLLLLLLLL0001
10000LLLLLLLLLLLLLLLLLL0001
100000LLLL0LLLLLL0LLLL00001
100000LLL000LLLL000LLL00001
100000LLL0S0LLLL0S0LLL00001
1000000LL000LLLL000LL000001
1000000LLLLLLLLLLLLLL000001
10000000LLLLL00LLLLL0000001
100000000LLLLLLLLLL00000001
100000000LLLLLLLLL000000001
100000000LLCCCCCLL000000001
1000000000LLLLLLLL000000001
10000000000LLLLL00000000001
1000000000000P0000000000001
111111111111111111111111111