1111111111111111111111111111111111
100000000000000C00000C00000C000001
100000010010000010100000000C000001
10000010010101010000C0000100000001
1P0000000C00C0000000000000000000C1
1111111111111111111111111111111111