11111111111111111111111111111111111111111111111111111111111111111111
10000000000000000000000000000000000000000000000000000000000000000001
000000P0000000000000000000C000000000000000000000000000000000000E0001
1000000000000000000000000000000C000000000000000000000C00000000000001
10000000000000000000000000000000000000000000000000000000000000000001
11111111111111111111111111111111111111111111111111111111111111111111