1111111111
1111111111
11C1111111
1111111111
111111E111
1111111111
1111111111
1111P11111
1111111111
1111111111