1111111111111111111111111
1P010000000C1000000000001
1001111001111111111001111
1000000000000000001000001
100111100C111001001001001
1001C00000001001000001001
1111001001111001111111111
1000001000001000001C00001
1001111111111111001001111
1001000001C00000000000001
1001001111001111111111001
10000C1001000000001000001
1001111001111C01111111111
11110010010000000C1000001
10010010C1001111111111001
1000000000000C0000C0000E1
1111111111111111111111111