111111111111111111111
111111111111111111111
111111111111111111111
1LLLLLLLLLLLLLLLLLLL1
1LLLLLLLLLLLLLLLLLLL1
111111111111111111111
111111111111111111111
11PE1C111111111111111
111111111111111111111