111111111111111111
1E00C0C00SS00C0001
1000000S0000000001
1S000000L0SS00S001
1PSSS000000000S001
1S0S000000S0000001
1001001000S0000001
10ES0S0000C0L00S01
10S0LS0000S00S0001
111111111111111111