1111111111111
1111111111111
11C11C1CCC111
11C11C1111C11
111CCC1CCCC11
11111C1C11111
11111C11CCC11
111111E111111
111111P111111
1111111111111