11111111111111
1C00C0C00C0011
1P1E1001C0C0E1
11111111111111