111111111111111111111
1C0000C00C00C00001EE1
1PEEE000C00000000EEE1
11EE10000000000001EE1
111111111111111111111