111111111111
10000LL11111
11111LL11111
11111LL11111
1LLLLLLLLLL1
1LLLLLLLLLL1
11111LL11111
11111LL11111
11111LL11111
11111LL11111
1P111CC111E1
111111111111
