1111111111111111111111111111111
1000000SSSS000000000SSSS0000001
10000SSSSSSSS00000SSSSSSSS00001
100SSSSSSSSSSSSSSSSSSSSSSSSS001
10SSSSSSSSSSSSSSSSSSSSSSSSSSS01
10SSSSSSSSSSSSSSSSSSSSSSSSSSS01
100SSSSSSSSSSSSSSSSSSSSSSSSS001
1000SSSSSSSSSSSSSSSSSSSSSSS0001
100000SSSSSSSSSSSSSSSSSSS000001
100000000SSSSSSSSSSSSS000000001
100000000000SSSSSSS000000000001
10000000000000SSS00000000000001
100000000000000S000000000000001
100000000000000E000000000000001
100000000000000C000000000000001
100000000000000P000000000000001
1111111111111111111111111111111