111111111111111111111111
1PSS000C0C0C000C000L0001
1SSS000L0000111111100001
1SSS00CC00CCC00000L00001
10011111100000CCC0000001
10000L00000L000010S00001
1000CC00001111000L000001
1000100S00000000001110L1
100000CC000L0000110L01E1
111111111111111111111111