111111111111111
1CCCCCCCCCCCCC1
1C11111111111C1
1C1C11C1CCC11C1
1C1C11C1111C1C1
1C11CCC1CCCC1C1
1C1111C1C1111C1
1C1111C11CCC1C1
1C11111E11111C1
1CCCCCCPCCCCCC1
111111111111111