111111111111111111111111111
100000000000000000000000001
101E1E1E1E1E1E1E1E1E1E1E101
101111111111111111111111101
10S1S1S1S1S1S1S1S1S1S1S1S01
101111111111111111111111101
101L1L1L1L1L1L1L1L1L1L1L101
101111111111111111111111101
10C1C1C1C1C1C1C1C1C1C1C1C01
101111111111111111111111101
101L1L1L1L1L1L1L1L1L1L1L101
101111111111111111111111101
10S1S1S1S1S1S1S1S1S1S1S1S01
101111111111111111111111101
101E1E1E1E1E1E1E1E1E1E1E101
1P0000000000000000000000001
111111111111111111111111111