1111111111111111111
100S00C0S0LCLCS00E1
1111CL1111S11111C01
1CLC0S00CCL01S01001
10L10L111C111001C01
1C010L10C0LC0SCLS01
1LS11110L11L1111001
10LC0L1L010C0L01C01
10L1111111L011CL111
1LC0LC0L01LC1LC1C01
10LC111111C01S01001
1LS0L01L010S0C0L001
1L01L11S01L01111001
1P0S00L0SL0C01CCLS1
1111111111111111111