1111111111111111111
100000000L000000001
100000001C100000001
1000000LCCCL0000001
1L11L11CCCCC01L11L1
100LCCCCCECCCCCL001
10000LCCCCCCCL00001
100001CCC1CCC100001
1000LCCL000LCCL0001
1001L0000P00000L101
1111111111111111111