111111111111111111111111111111111111111111111111111
1P10C000100000100C0C00C0C0100C00C000101000100000001
101110101110111111101111111111101111101010111011111
100C0010C0C00C00101010000C000000101000101010C000101
101111111110101010101011101011111010111110111010101
1000100C00101010000010101010001010100CC000100010001
101111101111111111101110101111101011111110101110111
1000100000101000000C001010001000001C000000100010001
111111111010111110101010101111101110101011111111101
1000100C00C00C0C001010001000000C0010101010100000101
1011111011101111111110111110111111101111101011111C1
10100C101000001000C000C00010001010000C0C00C0C010001
101010101111101111101111101011101111101110101111101
1000101010001010000000100C0000101000101010100000001
1011101110111011111011101110111011101C1011101111101
1010100C00000010100010000010C0C0C0C0000010001E10001
101011111111111010111011111111111011101111101010111
1000000010C010101010100C0C0C00101000101000001010001
101110111010101010101010101111101010111011111011101
101000000010001000100010100000100010001000001000001
111111111111111111111111111111111111111111111111111