1111111111111111111111111111111111111111111111
1P000000000010000000010010000010010000000000C1
1001111001111111001111001001111001111111111001
10C100100100000000100100C001000001001001001001
1111001001001111001001001111111001001001001001
1000C00000001001000000000C00001000001C00001001
1111001001001001111111001001001001111111001001
1000001001000000001000001001000000000001000001
1111001111C011111110011111111111110010C1001001
1000000001001001001000000000001000001000001001
10011110011110010C1001111001111111111111111111
10010000000000010000010C00000000000000000000E1
1111111111111111111111111111111111111111111111