111111111111111111111111111
1S1S1S1S1S1S1S1S1S1S1S1S1S1
1P1P1P1P1P1P1P1P1P1P1P1P1P1
111111111111111111111111111
1P1P1P1P1P1P1P1P1P1P1P1P1P1
111111111111111111111111111
1ECECECECECECECECECECECECC1
1S1S1S1S1S1S1S1S1S1S1S1S1S1
10L0L0L0L0L0L0L0L0L0L0L0L01
10L0L0L0L0L0L0L0L0L0L0L0L01
1S1S1S1S1S1S1S1S1S1S1S1S1S1
1ECECECECECECECECECECECECC1
1S1S1S1S1S1S1S1S1S1S1S1S1S1
1P1P1P1P1P1P1P1P1P1P1P1P1P1
111111111111111111111111111
1P1P1P1P1P1P1P1P1P1P1P1P1P1
1S1S1S1S1S1S1S1S1S1S1S1S1S1
111111111111111111111111111