111111111111111111111111111111111
1PC000000010000100000000111100001
100010001000100001100111100000001
100111000100100100001110000100001
100010100011100000000110011100001
111100000111110001000011100000101
111000100001110010000001110000111
101000010000100010000111100011101
101010100000100000111111001001111
100111000000100010000111000000101
100111100010000111000000111000001
1101110000100001110001000011001E1
111010001000110001001000001101111
111111111111111111111111111111111