111111111111111111111
100000000010000000001
1000000001C1000000001
100000000010000000001
100000000010000000001
100000000101000000001
100000001000100000001
100000010000010000001
100000100111001000001
100001000111000100001
100001111111111100001
100001000000000100001
100001000P00000100001
100001000111000100001
10000100011E000100001
100001000111000100001
111111111111111111111