11111
1CCC1
1E0E1
1CCC1
11C11
1CPC1
1C1C1
11111