1111111111111111111111111111111111111111111
10000CCCCCCCCCCCCCCCCCCCCCCCCCCCCCCCCC00001
100CCCCCCCCCCCCC0000000000000CCCCCC0CCCC001
10CCCCCCCCCCCCCCCCCCCCCCCCCC000000000CCCC01
1000CCCCCCCCCCCCCCCCCCCCCCCCCCC0000CCCC0001
100000CCCCCCCCCCCCCCCCCCCCCCCCCCCCCCC000001
10000000CCCCC00000000000000CCCCCCCC00000001
1000000000CCCCCCCC000000000CCCCCC0000000001
1000000000000CCCCCCCCCCCCCCCCC0000000000001
100000000000000CCCCCCCCCCCCC000000000000001
10000000000000000CCCCCCCCC00000000000000001
1P000000000000000000CEC00000000000000000001
1111111111111111111111111111111111111111111