1111111111111
1PC000C000CE1
100C0C0C0C001
1000C000C0001
1111111111111
1101101000111
1101101111011
1110001000011
1111101011111
1111101100011
1111111111111