11111111
1PCESLC1
1BNWW001
10B0C001
101011Z1
1K000111
11111111
