111111
1CSLE1
10BW01
1P0101
101001
110101
100101
101101
101101
111101
100001
101111
100K01
111111
