111111111111111111
11PSL0000N00000011
10011100C1100W0001
100100111001111001
101000000000000001
101100011100010001
101000001000111001
100000W00000010001
10W0000000W0000001
100011001110111101
101000000000000001
100010000100010001
101010100110110001
101010100000000001
100000100110110001
10W00010001010W001
10001000ZE00010001
10011100000011K001
110010000111100011
111111111111111111
