11111111
1PCESLC1
1BNWW001
10B0C001
111011Z1
1K1SS111
11111111
