111111111111
1W0001W000W1
111111111101
1PSSSSSSSS01
1BCCCCCC0BE1
1000LLL00LL1
100BL00000L1
1L1010011101
111W00000001
111111111101
100001010101
101001010101
1KW000000001
111111111111
