11111111111111111
1P0S000W0010000K1
1C00001110111W111
1L000001W10010111
1E000001011000001
1N00B000011000011
1000B000000001011
100000001W100Z1W1
11111111111111111
