111111111111
1W0001W000W1
111111111101
1PSSSSSSSS01
1BCCCCCCCCE1
10LLLLL00LL1
1000000000L1
101010011101
111W00000001
111111111101
110001010101
111101010101
1KW100000001
111111111111
