111111111111111111111111111111111111111
1PCE0000000000N000000000000000000000001
100CC0000000000000W0000000000W000000001
100111111000000000000000W00000W00000001
100K0000111100BBBBBBBB00010000000000001
1000000011100000010000LLLLLLL0000000001
10000W011111111110000L00000000000000001
10S000000000000000000000000000011000001
10000S000000001111111100000000010000001
10B000000010000Z00000000000000000000001
100000000000000000000000000000000000001
100000000000000000000000000000000000001
100000000000000000000000000000000000001
100000000000000000000000000000000000001
100000000000000000000000000000000000001
100000000000000000000000000000000000001
100000000000000000000000000000000000001
100000000000000000000000000000000000001
100000000000000000000000000000000000001
100000000000000000000000000000000000001
100000000000000000000000000000000000001
100000000000000000000000000000000000001
100000000000000000000000000000000000001
111111111111111111111111111111111111111
