111111111111111111111111111111
10000000000010001001C000C10001
100000C010000000C1100010000001
100000000100C0000000C000010001
1C01000100000100001010E0000001
101000C0000C0010C0000100000101
10C1000P101C0000000000001011C1
1000C000000000000C100000000101
1010100C0000000C1000000100C111
110C0001000001C010000000110011
111111111111111111111111111111
