1111111111
1C1C00CC11
1C1C111P11
10CC10C011
1C11111111
1C10CC0C11
10111C1011
1CCCCC1E11
1111111111
1111111111
