111111111111111111111111111111111111111
1010000000C00010001C00100C0000100000101
1010111011111110111C1110101C1110101C101
1000101000000010100000001P1010001010001
101110111111101011111011101110111011111
101000CC000C1010000010001000C0100010C01
1011111110111011111011111111111C1110101
1C0C1000100010C0001000100C000010C000101
111010101110111110111010111110111111101
100000100000E0001000CC001000000000C0001
111111111111111111111111111111111111111
111111111111111111111111111111111111111
