1111111111111111111111111111111
100C00100010CC10000010000010001
101110101010101C111010111C11101
1010C0001C001010001000100010001
10111111101110111C1111101110101
1010001000101000001000100000101
10101011111C1111111010111111101
10101C100E100C00100C10C01000001
101C1010101111101C1111111011111
100010001000C00C10C00C0000P0C01
1111111111111111111111111111111
