111111
1ZSSS1
1PCLK1
1SBLN1
1SBWE1
1WSSS1
111111
