111111
1SSSS1
1PCLK1
1ZSSN1
1SSWE1
1SSSS1
111111
