111111
1ZSSS1
1PCLK1
10BSN1
1SBWE1
1SSSS1
111111
