111111
1ZSSS1
1PCLK1
10BLN1
10BWE1
1WSSS1
111111
