111111
1PCLK1
1SSSS1
100WE1
111111
