11111111111111111111
1CCCC1CCCCCCCC1CCLC1
1C11C1C111111C1C1EC1
1C1CCCCCCCCCCCCCC1C1
1C1C11C11SS11C11C1C1
1C1C11C111111C11C1C1
1C1CCCCCCCCCCCCCC1C1
1C11C1C111111C1C11C1
1PCCC1CCCCCCCC1CCCC1
11111111111111111111