1111111111
1EC0C0PCE1
1111111111