111111
1P0E01
110011
10C001
111111

