1111111111111111111111
1000000000000000000001
1011111111111111000001
1010000000000000000101
1010000111111111110101
1010100000000000010101
1010101111111000000101
1010100000000000010101
1010100P0E0C0000010101
1010100000000000010101
1010111111111111110101
1010000000000000000101
1011111111111111111101
100000000000C000000001
1111111111111111111111