1111111111111111111111111111111111
100000E0000000X0000000000000000001
1010010100100000101001000000010101
1010010010101010001001000000010101
1P00000000000000000000000🐝00000001
1111111111111111111111111111111111