1111111111
1EC0000001
11111111C1
1CP0000001
11111111C1
1C00000001
1111111111