1111111111
10000000E1
1010010001
1010010001
1010C100C1
1011111111
1000C1EEE1
100001EEE1
100001EEE1
1P0001EEE1
1111111111